###############
#     @       #
#             #
#             #
#             #
#             #
#             #
#             #
#             #
#             #
#             #
#             #
#             #
#      x      #
###############
